###########################################################
#......#...........................................#......#
#.........................................................#
#......#...........................................#......#
########...........................................########
#.........................................................#
#.........................................................#
#.........................................................#
#.........................................................#
#.........................................................#
#.........................................................#
#.........................................................#
#.........................................................#
#.........................................................#
#.........................................................#
#.........................................................#
#.........................................................#
#.........................................................#
#.........................................................#
########...........................................########
#......#...........................................#......#
#.........................................................#
#......#...........................................#......#
###########################################################